281 88 8
0 0 0 0 0 0 0 0 0 0 0 0 0 0 0 0 0 0 0 0 0 0 0 0 0 0 0 0 0 0 0 0 0 0 0 0 0 0 0 0 0 0 0 0 0 0 0 0 0 0 0 0 0 0 0 0 0 0 0 0 0 0 0 0 0 0 0 0 0 0 0 0 0 0 0 0 0 0 0 0 0 0 0 0 0 0 0 0
1 2 3 4 1 2 3 4 1 5 6 4 1 2 3 7 8 2 9 10 4 4 4 1 2 11 12 13 14 4 7 8 15 8 15 8 15 8 16 7 10 17 18 14 19 12 13 20 21 22 23 24 22 22 22 23 24 23 24 22 22 22 25 26 4 1 13 14 1 15 10 1 2 27 28 29 30 31 16 29 30 31 16 29 32 33 34 35
36 37 38 39 40 37 38 39 40 41 42 39 40 37 38 43 44 37 45 46 47 47 47 40 48 49 50 51 52 47 53 44 54 55 54 55 54 55 56 57 46 58 59 52 60 50 61 62 63 64 65 66 67 68 68 69 70 71 72 73 67 68 74 75 76 36 51 52 40 54 46 40 37 77 78 79 80 81 82 83 80 81 82 83 84 85 86 87
88 89 90 46 40 91 92 46 40 37 45 46 40 91 92 93 88 91 94 95 47 96 97 98 99 100 101 102 103 104 58 88 105 50 105 50 105 50 106 107 95 96 97 108 109 110 111 112 113 114 115 116 73 117 118 119 120 121 122 73 123 124 124 125 126 127 102 103 128 105 95 40 89 129 52 40 130 131 132 133 130 131 134 135 48 49 136 137
40 138 139 95 40 89 140 141 142 91 94 95 40 89 140 95 40 91 94 143 97 144 145 146 147 148 149 150 151 152 153 154 105 50 105 50 105 50 155 156 143 157 158 159 160 161 162 163 164 165 166 167 168 169 170 171 172 173 174 168 175 176 177 178 179 161 180 151 181 182 183 184 185 186 104 40 56 40 56 40 56 40 155 44 187 188 189 190
40 56 60 141 142 138 139 191 44 89 140 95 40 138 139 192 36 89 193 194 158 195 196 197 56 58 88 198 199 200 201 202 105 50 105 50 105 50 203 204 194 158 205 206 47 40 207 208 209 210 211 212 166 213 214 215 216 217 218 166 213 219 220 221 222 40 198 223 224 225 149 225 226 227 228 128 56 40 56 40 56 40 51 88 229 145 230 231
232 233 234 235 236 233 234 237 238 99 239 240 232 233 234 237 238 99 241 242 243 244 245 232 233 246 232 233 232 247 248 236 249 110 249 110 249 110 247 250 242 243 244 245 246 232 251 252 253 254 115 255 256 111 257 258 216 259 260 261 111 257 262 263 264 232 233 265 236 266 238 266 267 268 269 270 233 232 233 232 233 232 233 232 271 272 273 274
275 275 275 275 275 275 275 275 275 275 275 275 275 275 275 275 275 275 275 275 275 275 275 275 275 275 275 275 275 275 275 275 275 275 275 275 275 275 275 275 275 275 275 275 275 275 275 275 275 276 275 275 275 275 275 277 278 279 275 276 275 275 275 275 275 275 275 275 275 275 275 275 275 275 275 275 275 275 275 275 275 275 275 275 275 275 275 280
