33 16 7
0 1 0 0 0 0 0 0 2 2 0 1 0 0 0 0
3 4 5 6 7 7 6 7 3 7 8 4 5 7 8 9
10 11 4 12 7 7 13 7 8 7 8 11 4 5 8 9
12 14 14 15 16 16 12 7 17 7 17 14 14 18 17 9
6 19 19 6 20 21 3 22 3 22 3 21 23 19 3 24
25 26 26 25 26 27 28 29 28 29 28 27 29 26 17 30
31 31 31 31 31 31 31 31 31 31 31 31 31 31 32 31
